Ars Amatoria v.1
An Interactive Fiction by André AnJoMorto F.
Release 1 / Serial number 240210 / Inform 7 build 6M62 (I6/v6.34 lib 6/12N) SD

Exam Room
I stumble one more time out of the final exam, the weight of textbooks finally off my shoulders. There she is, standing in the corridor, the girl I've barely spoken to all semester, if I can even say that now, but I can't get her out of my mind. She's laughing. My heart races; this is my chance, maybe my last chance, once again... one more time...

 The room is chaotic as students rush out, relieved that the ordeal is over. I catch glimpses of stressed faces and hear a mix of sighs and chatter. A sea of people flows towards the corridor.

>Go outside
Corridor
The corridor is chaotic as students rush out, relieved that the ordeal is over. I catch glimpses of stressed faces and hear a mix of sighs and chatter. A sea of people flows towards the exit door. And there she still stands.

You can see a Beautiful Girl here.

>go outside
Front of the School

>go inside
Corridor
You can see a Beautiful Girl here.

>go inside
Exam Room
I stumble one more time out of the final exam, the weight of textbooks finally off my shoulders. There she is, standing in the corridor, the girl I've barely spoken to all semester, if I can even say that now, but I can't get her out of my mind. She's laughing. My heart races; this is my chance, maybe my last chance, once again... one more time...

>go outside
Corridor
You can see a Beautiful Girl here.

>go toilet
You can't see any such thing.

>go in the toilet
You can't see any such thing.

* * *

>Look
Exam Room
The exam room is chaotic as students rush out, relieved that the ordeal is over. I catch glimpses of stressed faces and hear a mix of sighs and chatter. A sea of people flows towards the exit door.

* * *

>examine
What do you want to examine?

>examine exam room
You can't see any such thing.

>examine room
You can't see any such thing.

* * *

>examine exam room
You can't see any such thing.

>look
Exam Room
I stumble one more time out of the final exam, the weight of textbooks finally off my shoulders. There she is, the girl I've barely spoken to all semester, if I can even say that now, but I can't get her out of my mind. She's laughing. My heart races; this is my chance, maybe my last chance, once again...

>see
That's not a verb I recognise.

>wait
I wait for a moment, uncertain of what to say. 
 Jackson comes from behind me, friendly punches me in the shoulder and happily asks:
 "So how was it?"
 Still surprised I answer:
 "It was alright."
 As I look back at the corridor, the girl is not there anymore. I've lost my chance...

    *** I got to be quicker, noted, time to go back. ***

Would you like to RESTART, RESTORE a saved game, QUIT or UNDO the last command?

Please give one of the answers above.

Would you like to RESTART, RESTORE a saved game, QUIT or UNDO the last command?

* * *

>go outside
Corridor
You can see a Beautiful Girl here.

>go inside
Toilet

* * *

>look
Exam Room
 The room is chaotic as students rush out, relieved that the ordeal is over. I catch glimpses of stressed faces and hear a mix of sighs and chatter. A sea of people flows towards the corridor.

>wait
I wait for a moment, uncertain of what to say. 

 Jackson comes from behind me, friendly punches me in the shoulder and happily asks:
 "So how was it?"

 Still surprised I answer:
 "It was alright."

 As I look back at the corridor, the girl is not there anymore. I've lost my chance...

    *** I got to be quicker, noted, time to go back. ***

Would you like to RESTART, RESTORE a saved game, QUIT or UNDO the last command?

* * *

>sleep
You aren't feeling especially drowsy.

>eat
(yourself)
You're plainly inedible.

>say
I didn't understand that sentence.

>cry
That's not a verb I recognise.

>follow
That's not a verb I recognise.

>run
You'll have to say which compass direction to go in.

>run north
You can't go that way.

>Run toilet
You can't see any such thing.

>toilet
That's not a verb I recognise.

>Go to toilet
You can't see any such thing.

>Look
The exam room is chaotic as students rush out, relieved that the ordeal is over. I catch glimpses of stressed faces and hear a mix of sighs and chatter. A sea of people flows towards the exit door.

>Exit
But you aren't in anything at the moment.

>Leave
But you aren't in anything at the moment.

>Wait
I wait for a moment, uncertain of what to say. 
 Jackson comes from behind me, friendly punches me in the shoulder and happily asks:
 "So how was it?"
 Still surprised I answer:
 "It was alright."
 As I look back at the corridor, the girl is not there anymore. I've lost my chance...

    *** I got to be quicker, noted, time to go back. ***

Would you like to RESTART, RESTORE a saved game, QUIT or UNDO the last command?

Please give one of the answers above.

Would you like to RESTART, RESTORE a saved game, QUIT or UNDO the last command?

>Restart
Ars Amatoria v.1
An Interactive Fiction by André AnJoMorto F.
Release 1 / Serial number 240203 / Inform 7 build 6M62 (I6/v6.34 lib 6/12N) SD

The exam room is chaotic as students rush out, relieved that the ordeal is over. I catch glimpses of stressed faces and hear a mix of sighs and chatter. A sea of people flows towards the exit door.

* * *

>wait
I wait for a moment, uncertain of what to say. 
 Jackson comes from behind me, friendly punches me in the shoulder and happily asks:
 "So how was it?"
 Still surprised I answer:
 "It was alright."
 As I look back at the corridor, the girl is not there anymore. I've lost my chance...

    *** I got to be quicker, noted, time to go back. ***

Would you like to RESTART, RESTORE a saved game, QUIT or UNDO the last command?

* * *

Please give one of the answers above.

Would you like to RESTART, RESTORE a saved game, QUIT or UNDO the last command?

>restart
Ars Amatoria v.1
An Interactive Fiction by André AnJoMorto F.
Release 1 / Serial number 231212 / Inform 7 build 6M62 (I6/v6.34 lib 6/12N) SD

Exam Room
I stumble one more time out of the final exam, the weight of textbooks finally off my shoulders. There she is, the girl I've barely spoken to all semester, if I can even say that now, but I can't get her out of my mind. She's laughing. My heart races; this is my chance, maybe my last chance, once again...

>go north
You can't go that way.

>go south
You can't go that way.

>go east
You can't go that way.

>go west
You can't go that way.

* * *

>walk
You'll have to say which compass direction to go in.

>walk north
You can't go that way.